0041000a
00820005
00c30002
01c70008
01860088
31020400
40410c00
20820c00
5107002c
60000014
70440002
81420005
11010c00
50460044
6000002c